..............
.......#XXX#..
.......XXXXX..
..#XXXX#X#X#..
..XXXXXXXX....
..XXXXXXX#X#..
..XXXXXXXXXX..
..#XXXXXX#XX..
.........#X#..
..............